R 1000 1000

NO ./Sci-fi_wall3.xpm
WE ./Sci-fi_wall2.xpm
SO ./Sci-fi_wall4.xpm
EA ./Sci-fi_wall5.xpm
S ./etoile.xpm    
C 176,217,244                   
F 239, 198, 117
 
        111111111111111111 1111111
        1000000000110000001000001
        1011000001110000000000001
        1001000000000000000000001     
111111111011000001110000000000001
100000000011000001110111111111111
11110111111111011100000010001
11110111111111011101010010001
11000000110101011100000010001     
10000000000200021100000010001  
1000000000020N001101010010001         
11000001110121011111011110001
11110111 1110101 101111010001
11111111 1111111 111111111111
