R 10000 10000                  

NO ./mur1.xpm
SO ./mur2.xpm
WE ./mur3.xpm
EA ./mur4.xpm            
S ./etoile.xpm

F 255, 93,     0
C 0,    97, 255      


1111111111111111111111111
1000200200110000000000021
10020002000000N0000000001
1111111111111111111111111