R 1100 1100                  

NO ./mur1.xpm
SO ./mur2.xpm
WE ./mur3.xpm
EA ./mur4.xpm
S ./etoile.xpm

F 255,93,0
C 0,97,255      


        1111111111111111111111111
        1000200200110000000000021
        1002000200000000000000001
        100100W000020000000000001
        1111111111111111111111111