R 1500 1500

NO ./images/Sci-fi_wall3.xpm
WE ./images/Sci-fi_wall2.xpm
SO ./images/Sci-fi_wall4.xpm
EA ./images/Sci-fi_wall5.xpm
S ./images/etoile.xpm    
C 176, 217, 244                   
F 239, 198, 117
 
        1111111111111111111111111
        1000000000110000001000001
        1011000001110000000000001
        1001000000000000000000001     
111111111011000001110000000000001
100000000011000001110111111111111
11110111111111011100000010001
11110111111111011101010010001
11000000110101011100000010001     
10000002000020001100000010001  
1000200200000W001101010000001         
11002001110101011111011110001
11110111 1110101 101111010001
11111111 1111111 111111111111
