R 10000 10000                  

NO ./images/mur1.xpm
SO ./images/mur2.xpm
WE ./images/mur3.xpm
EA ./images/mur4.xpm            
S ./images/etoile.xpm

F 255, 93,     0
C 0,    97, 255      


1111111111111111111111111
1000200200110000000000021
10020002000000N0000000001
1111111111111111111111111