R 524 657                  

NO ./images/mur1.xpm
SO ./images/mur2.xpm
WE ./images/mur3.xpm
EA ./images/mur4.xpm            
S ./images/etoile.xpm

F 255,93,0
C 0,97,255      


11111
1E221
11111